
######################
#@     #        #    #
# ### ##### ### # ####
#   #     #   # #   ##
### # ### # # # ### ##
#   #   #   # #     ##
# ##### ####### ######
#       #       #    #
######### ####### ## #
#G        #          #
######################
