🪨🪨🪨🪨🪨🪨🪨🪨🪨🪨🪨🪨🪨🪨🪨🪨🪨🪨🪨🪨🪨🪨🪨🪨
🪨🌊🌊🌊🌊🌊🌊🌊🌊🌊🌊🌊🌊🌊🌊🌊🌊🌊🌊🌊🌊🌊🌊🪨
🪨🌊👾     🪨        🪨    🌊🪨
🪨🌊 🪨🪨🪨 🪨🪨🪨🪨🪨 🪨🪨🪨 🪨 🪨🪨🪨🌊🪨
🪨🌊   🪨     🪨   🪨 🪨   🪨🌊🪨
🪨🌊🪨🪨 🪨 🪨🪨🪨 🪨 🪨 🪨 🪨🪨🪨 🪨🌊🪨
🪨🌊   🪨   🪨   🪨 🪨     🪨🌊🪨
🪨🌊 🪨🪨🪨🪨🪨 🪨🪨🪨🪨🪨🪨🪨 🪨🪨🪨🪨🪨🌊🪨
🪨🌊       🪨       🪨    🌊🪨
🪨🌊🪨🪨🪨🪨🪨🪨🪨🪨 🪨🪨🪨🪨🪨🪨🪨 🪨🪨 🌊🪨
🪨🌊🚪        🪨          🌊🪨
🪨🌊🌊🌊🌊🌊🌊🌊🌊🌊🌊🌊🌊🌊🌊🌊🌊🌊🌊🌊🌊🌊🌊🪨
🪨🪨🪨🪨🪨🪨🪨🪨🪨🪨🪨🪨🪨🪨🪨🪨🪨🪨🪨🪨🪨🪨🪨🪨
